1111111111111111
0000000000000000
0E00000000000000
0000000000000000
0000000000000000
0000000000000000
0000000000000000
00000000000000P0
0000000000000000