1111111111111111
01E1111111111E10
00B0BBE11EBB0B00
0000111111110000
0000100000010000
E01000000000010E
0000000000000000
E01000000000010E
11100000P0000111