1111111111111111
0000000P00000000
0000000000000000
000G000000000000
0000011111000000
0000000000000000
0000000E0000G000
0000000000000000
00E0000000000E00