1111111111111111
0000000E00000000
0000000000000000
0000011111000000
0000000000000000
0000000P00000000
0000011111000000
0000000000000000
0000000E00000000