1111111111111111
0001000000000000
0E01000000000000
0001000000000000
0001000000000000
0000000000001000
0000000000001000
00000000000010P0
0000000000001000