1111111111111111
1111000000000000
EBBE000100000000
1111000000010000
EBBE0000000100P0
1111000000010000
EBBE000100000000
1111000000000000
EBBE000000000000