1111111111111111
0000100000100000
0E00100P001000E0
0000100000100000
0000100000100000
00000BBBBB000000
0000000000000000
00E00000E0000E00
0000000000000000