B11111111111111B
1001000011111111
0000P00v11111111
0000000w11111111
0000000x11111111
0000000y11111111
0000000z11111111
1001000011111111
B11111111111111B