1111111111111111
0000000000000000
0G000000000000G0
0000000000000000
00000000P0000000
0000000000000000
0000000000000000
0G000000000000G0
0000000000000000