1111111111111111
0000000000000000
0000000000000000
0000000000000000
0000000B00000000
00B000BPB000B000
0000000B00000000
0000000000000000
0000000000000000