1111111111111111
E00000000000000E
0110000000000110
0000000000000000
1000000000000001
1000000P00000001
0000000000000000
0110000000000110
E00000000000000E