1111111111111111
000000110000B000
0E0E0011E00B10E0
0101001100001000
0E0000BB00E01000
0000101100001000
001E00110000B000
000000110E001000
E00000BB0000100P