1111111111111111
EB00000000000000
B000000000111100
0000000000BEE100
0000000000BEE100
0000000000111100
0000000000000000
00000000P0000000
0000000000000000